date,country,Tor Relay,Tor Bridges,Total Users Estimated,frac
1/1/13,iq,392,3,395,59
1/2/13,iq,440,2,442,58
1/3/13,iq,432,4,436,60
1/4/13,iq,448,6,454,58
1/5/13,iq,445,6,451,60
1/6/13,iq,452,6,458,57
1/7/13,iq,438,8,446,58
1/8/13,iq,417,5,422,60
1/9/13,iq,406,3,409,60
1/10/13,iq,404,5,409,59
1/11/13,iq,397,6,403,58
1/12/13,iq,379,6,385,59
1/13/13,iq,377,3,380,60
1/14/13,iq,389,3,392,58
1/15/13,iq,387,6,393,57
1/16/13,iq,371,7,378,59
1/17/13,iq,398,7,405,50
1/18/13,iq,370,6,376,54
1/19/13,iq,371,6,377,47
1/20/13,iq,371,3,374,48
1/21/13,iq,404,2,406,47
1/22/13,iq,415,4,419,47
1/23/13,iq,422,4,426,46
1/24/13,iq,408,5,413,55
1/25/13,iq,449,2,451,55
1/26/13,iq,375,2,377,57
1/27/13,iq,415,2,417,55
1/28/13,iq,411,5,416,53
1/29/13,iq,404,6,410,57
1/30/13,iq,399,9,408,53
1/31/13,iq,392,8,400,54
2/1/13,iq,416,3,419,54
2/2/13,iq,411,7,418,52
2/3/13,iq,343,11,354,68
2/4/13,iq,276,12,288,85
2/5/13,iq,301,9,310,75
2/6/13,iq,382,9,391,56
2/7/13,iq,381,5,386,63
2/8/13,iq,398,3,401,61
2/9/13,iq,384,3,387,63
2/10/13,iq,416,5,421,63
2/11/13,iq,402,5,407,61
2/12/13,iq,396,6,402,64
2/13/13,iq,408,8,416,63
2/14/13,iq,419,6,425,61
2/15/13,iq,399,7,406,63
2/16/13,iq,365,7,372,66
2/17/13,iq,385,6,391,67
2/18/13,iq,372,5,377,66
2/19/13,iq,383,9,392,58
2/20/13,iq,378,6,384,62
2/21/13,iq,358,6,364,63
2/22/13,iq,370,6,376,61
2/23/13,iq,366,5,371,60
2/24/13,iq,364,7,371,56
2/25/13,iq,378,5,383,58
2/26/13,iq,368,7,375,57
2/27/13,iq,396,8,404,55
2/28/13,iq,412,11,423,56
3/1/13,iq,436,12,448,57
3/2/13,iq,443,9,452,58
3/3/13,iq,431,4,435,58
3/4/13,iq,419,2,421,61
3/5/13,iq,461,4,465,58
3/6/13,iq,472,5,477,55
3/7/13,iq,443,8,451,54
3/8/13,iq,432,12,444,57
3/9/13,iq,406,24,430,63
3/10/13,iq,410,15,425,57
3/11/13,iq,407,8,415,56
3/12/13,iq,381,6,387,54
3/13/13,iq,369,2,371,63
3/14/13,iq,416,1,417,60
3/15/13,iq,470,2,472,58
3/16/13,iq,539,4,543,56
3/17/13,iq,577,4,581,54
3/18/13,iq,558,3,561,56
3/19/13,iq,566,2,568,57
3/20/13,iq,601,7,608,57
3/21/13,iq,612,13,625,57
3/22/13,iq,631,11,642,55
3/23/13,iq,623,11,634,55
3/24/13,iq,624,14,638,55
3/25/13,iq,595,9,604,56
3/26/13,iq,569,5,574,57
3/27/13,iq,551,11,562,57
3/28/13,iq,544,11,555,56
3/29/13,iq,568,9,577,54
3/30/13,iq,589,5,594,54
3/31/13,iq,592,8,600,54
4/1/13,iq,580,7,587,52
4/2/13,iq,570,9,579,53
4/3/13,iq,547,10,557,56
4/4/13,iq,545,14,559,55
4/5/13,iq,537,17,554,54
4/6/13,iq,537,12,549,53
4/7/13,iq,536,8,544,54
4/8/13,iq,514,11,525,54
4/9/13,iq,471,7,478,59
4/10/13,iq,499,7,506,58
4/11/13,iq,510,9,519,57
4/12/13,iq,501,4,505,59
4/13/13,iq,472,3,475,61
4/14/13,iq,486,5,491,60
4/15/13,iq,489,5,494,58
4/16/13,iq,493,5,498,61
4/17/13,iq,479,3,482,62
4/18/13,iq,480,2,482,62
4/19/13,iq,497,2,499,61
4/20/13,iq,497,3,500,62
4/21/13,iq,473,2,475,63
4/22/13,iq,449,7,456,63
4/23/13,iq,459,9,468,64
4/24/13,iq,462,12,474,65
4/25/13,iq,459,7,466,64
4/26/13,iq,464,8,472,64
4/27/13,iq,506,13,519,58
4/28/13,iq,488,10,498,58
4/29/13,iq,487,4,491,60
4/30/13,iq,474,2,476,61
5/1/13,iq,481,2,483,59
5/2/13,iq,479,0,479,59
5/3/13,iq,469,2,471,59
5/4/13,iq,467,4,471,58
5/5/13,iq,481,5,486,57
5/6/13,iq,484,3,487,58
5/7/13,iq,472,4,476,60
5/8/13,iq,472,4,476,59
5/9/13,iq,450,3,453,62
5/10/13,iq,430,3,433,62
5/11/13,iq,440,3,443,62
5/12/13,iq,427,5,432,62
5/13/13,iq,415,4,419,64
5/14/13,iq,426,6,432,65
5/15/13,iq,433,2,435,62
5/16/13,iq,491,3,494,58
5/17/13,iq,497,5,502,58
5/18/13,iq,501,6,507,56
5/19/13,iq,475,4,479,57
5/20/13,iq,443,1,444,59
5/21/13,iq,443,3,446,60
5/22/13,iq,464,4,468,59
5/23/13,iq,472,4,476,61
5/24/13,iq,469,6,475,60
5/25/13,iq,471,3,474,58
5/26/13,iq,460,2,462,59
5/27/13,iq,472,4,476,59
5/28/13,iq,432,5,437,61
5/29/13,iq,456,5,461,60
5/30/13,iq,475,7,482,61
5/31/13,iq,498,7,505,61
6/1/13,iq,468,7,475,60
6/2/13,iq,465,7,472,59
6/3/13,iq,459,5,464,60
6/4/13,iq,423,7,430,60
6/5/13,iq,425,5,430,60
6/6/13,iq,427,4,431,62
6/7/13,iq,433,3,436,65
6/8/13,iq,474,12,486,57
6/9/13,iq,468,8,476,57
6/10/13,iq,466,6,472,59
6/11/13,iq,444,4,448,60
6/12/13,iq,436,5,441,63
6/13/13,iq,474,2,476,61
6/14/13,iq,490,5,495,60
6/15/13,iq,469,7,476,63
6/16/13,iq,509,5,514,63
6/17/13,iq,488,4,492,66
6/18/13,iq,470,5,475,65
6/19/13,iq,508,5,513,62
6/20/13,iq,539,4,543,58
6/21/13,iq,534,4,538,58
6/22/13,iq,490,6,496,59
6/23/13,iq,483,5,488,61
6/24/13,iq,472,6,478,62
6/25/13,iq,477,7,484,63
6/26/13,iq,495,5,500,61
6/27/13,iq,497,3,500,64
6/28/13,iq,513,3,516,60
6/29/13,iq,528,4,532,58
6/30/13,iq,535,4,539,59
7/1/13,iq,533,3,536,58
7/2/13,iq,500,3,503,59
7/3/13,iq,512,2,514,60
7/4/13,iq,532,4,536,59
7/5/13,iq,530,3,533,57
7/6/13,iq,540,4,544,57
7/7/13,iq,525,2,527,57
7/8/13,iq,521,2,523,59
7/9/13,iq,527,1,528,60
7/10/13,iq,481,2,483,62
7/11/13,iq,470,2,472,65
7/12/13,iq,506,3,509,65
7/13/13,iq,537,3,540,63
7/14/13,iq,507,3,510,62
7/15/13,iq,486,3,489,64
7/16/13,iq,522,7,529,61
7/17/13,iq,542,6,548,59
7/18/13,iq,556,3,559,59
7/19/13,iq,549,5,554,59
7/20/13,iq,565,2,567,58
7/21/13,iq,584,2,586,58
7/22/13,iq,545,1,546,64
7/23/13,iq,528,3,531,62
7/24/13,iq,532,2,534,62
7/25/13,iq,545,2,547,61
7/26/13,iq,493,2,495,65
7/27/13,iq,540,2,542,60
7/28/13,iq,540,2,542,60
7/29/13,iq,534,4,538,61
7/30/13,iq,567,5,572,61
7/31/13,iq,554,5,559,62
8/1/13,iq,543,8,551,62
8/2/13,iq,548,9,557,60
8/3/13,iq,550,8,558,60
8/4/13,iq,552,6,558,60
8/5/13,iq,535,5,540,61
8/6/13,iq,538,9,547,62
8/7/13,iq,514,14,528,62
8/8/13,iq,524,8,532,62
8/9/13,iq,513,6,519,61
8/10/13,iq,513,5,518,63
8/11/13,iq,505,6,511,63
8/12/13,iq,531,4,535,61
8/13/13,iq,517,4,521,62
8/14/13,iq,514,5,519,66
8/15/13,iq,517,6,523,64
8/16/13,iq,534,7,541,63
8/17/13,iq,615,4,619,59
8/18/13,iq,619,4,623,58
8/19/13,iq,607,4,611,59
8/20/13,iq,657,2,659,60
8/21/13,iq,698,1,699,59
8/22/13,iq,741,3,744,60
8/23/13,iq,822,5,827,61
8/24/13,iq,935,4,939,61
8/25/13,iq,991,5,996,61
8/26/13,iq,977,4,981,63
8/27/13,iq,980,4,984,62
8/28/13,iq,1057,3,1060,62
8/29/13,iq,1200,1,1201,58
8/30/13,iq,1370,2,1372,58
8/31/13,iq,1604,2,1606,59
9/1/13,iq,1902,1,1903,59
9/2/13,iq,2115,1,2116,60
9/3/13,iq,2287,4,2291,62
9/4/13,iq,2527,4,2531,59
9/5/13,iq,2544,1,2545,55
9/6/13,iq,2701,2,2703,62
9/7/13,iq,2875,6,2881,59
9/8/13,iq,2987,7,2994,57
9/9/13,iq,3139,5,3144,64
9/10/13,iq,3163,8,3171,59
9/11/13,iq,2986,7,2993,63
9/12/13,iq,2949,9,2958,63
9/13/13,iq,2930,9,2939,63
9/14/13,iq,3025,5,3030,63
9/15/13,iq,3026,5,3031,62
9/16/13,iq,2972,5,2977,63
9/17/13,iq,2901,5,2906,63
9/18/13,iq,2949,9,2958,62
9/19/13,iq,2877,8,2885,63
9/20/13,iq,2848,9,2857,63
9/21/13,iq,2924,6,2930,59
9/22/13,iq,2848,2,2850,62
9/23/13,iq,2767,2,2769,65
9/24/13,iq,2699,2,2701,65
9/25/13,iq,2714,2,2716,65
9/26/13,iq,2687,3,2690,66
9/27/13,iq,2857,4,2861,65
9/28/13,iq,2782,4,2786,65
9/29/13,iq,2584,3,2587,66
9/30/13,iq,2467,5,2472,67
10/1/13,iq,2386,4,2390,66
10/2/13,iq,2468,6,2474,66
10/3/13,iq,2416,7,2423,65
10/4/13,iq,2457,7,2464,66
10/5/13,iq,2509,6,2515,66
10/6/13,iq,2487,7,2494,65
10/7/13,iq,2400,6,2406,66
10/8/13,iq,2292,5,2297,67
10/9/13,iq,2195,7,2202,68
10/10/13,iq,2082,6,2088,67
10/11/13,iq,2026,5,2031,67
10/12/13,iq,2161,3,2164,67
10/13/13,iq,2072,4,2076,67
10/14/13,iq,2057,8,2065,67
10/15/13,iq,1929,7,1936,68
10/16/13,iq,1846,6,1852,69
10/17/13,iq,1819,8,1827,69
10/18/13,iq,1985,7,1992,68
10/19/13,iq,1997,4,2001,68
10/20/13,iq,1951,3,1954,68
10/21/13,iq,1933,5,1938,69
10/22/13,iq,1927,6,1933,70
10/23/13,iq,1893,6,1899,69
10/24/13,iq,1917,6,1923,68
10/25/13,iq,1932,6,1938,69
10/26/13,iq,1936,8,1944,68
10/27/13,iq,1872,6,1878,69
10/28/13,iq,1840,6,1846,70
10/29/13,iq,1820,6,1826,70
10/30/13,iq,1812,9,1821,65
10/31/13,iq,1831,9,1840,68
11/1/13,iq,1852,6,1858,69
11/2/13,iq,1815,5,1820,68
11/3/13,iq,1734,5,1739,68
11/4/13,iq,1709,5,1714,69
11/5/13,iq,1768,7,1775,69
11/6/13,iq,1709,7,1716,69
11/7/13,iq,1701,10,1711,70
11/8/13,iq,1759,8,1767,69
11/9/13,iq,1716,3,1719,68
11/10/13,iq,1626,4,1630,68
11/11/13,iq,1676,5,1681,68
11/12/13,iq,1663,6,1669,70
11/13/13,iq,1685,5,1690,70
11/14/13,iq,1709,5,1714,70
11/15/13,iq,1643,2,1645,69
11/16/13,iq,1590,4,1594,69
11/17/13,iq,1477,4,1481,68
11/18/13,iq,1420,4,1424,68
11/19/13,iq,1433,4,1437,67
11/20/13,iq,1506,4,1510,67
11/21/13,iq,1611,3,1614,67
11/22/13,iq,1601,5,1606,68
11/23/13,iq,1519,9,1528,68
11/24/13,iq,1434,8,1442,67
11/25/13,iq,1401,3,1404,69
11/26/13,iq,1390,5,1395,68
11/27/13,iq,1386,5,1391,68
11/28/13,iq,1417,4,1421,68
11/29/13,iq,1514,5,1519,67
11/30/13,iq,1478,5,1483,67
12/1/13,iq,1417,4,1421,66
12/2/13,iq,1375,6,1381,67
12/3/13,iq,1384,6,1390,67
12/4/13,iq,1428,4,1432,67
12/5/13,iq,1457,4,1461,68
12/6/13,iq,1427,7,1434,68
12/7/13,iq,1430,7,1437,66
12/8/13,iq,1424,7,1431,63
12/9/13,iq,1384,7,1391,67
12/10/13,iq,1304,6,1310,67
12/11/13,iq,1280,8,1288,68
12/12/13,iq,1350,6,1356,68
12/13/13,iq,1362,5,1367,68
12/14/13,iq,1363,7,1370,67
12/15/13,iq,1297,5,1302,65
12/16/13,iq,1265,4,1269,69
12/17/13,iq,1273,9,1282,70
12/18/13,iq,1294,8,1302,69
12/19/13,iq,1338,7,1345,69
12/20/13,iq,1318,8,1326,71
12/21/13,iq,1365,7,1372,68
12/22/13,iq,1351,7,1358,68
12/23/13,iq,1385,5,1390,68
12/24/13,iq,1492,5,1497,68
12/25/13,iq,1489,5,1494,68
12/26/13,iq,1462,4,1466,67
12/27/13,iq,1445,3,1448,66
12/28/13,iq,1385,5,1390,66
12/29/13,iq,1373,5,1378,67
12/30/13,iq,1437,3,1440,67
12/31/13,iq,1411,3,1414,66
1/1/14,iq,1396,4,1400,64
1/2/14,iq,1399,5,1404,64
1/3/14,iq,1393,10,1403,65
1/4/14,iq,1381,7,1388,67
1/5/14,iq,1407,4,1411,67
1/6/14,iq,1381,6,1387,67
1/7/14,iq,1324,8,1332,67
1/8/14,iq,1350,3,1353,67
1/9/14,iq,1370,6,1376,67
1/10/14,iq,1331,7,1338,69
1/11/14,iq,1304,5,1309,70
1/12/14,iq,1402,6,1408,66
1/13/14,iq,1400,6,1406,67
1/14/14,iq,1364,3,1367,67
1/15/14,iq,1372,4,1376,67
1/16/14,iq,1358,5,1363,67
1/17/14,iq,1354,6,1360,66
1/18/14,iq,1328,4,1332,66
1/19/14,iq,1312,10,1322,64
1/20/14,iq,1294,4,1298,66
1/21/14,iq,1261,4,1265,67
1/22/14,iq,1235,3,1238,67
1/23/14,iq,1316,7,1323,67
1/24/14,iq,1258,7,1265,66
1/25/14,iq,1285,4,1289,66
1/26/14,iq,1293,4,1297,66
1/27/14,iq,1267,5,1272,66
1/28/14,iq,1287,6,1293,67
1/29/14,iq,1294,5,1299,69
1/30/14,iq,1274,5,1279,70
1/31/14,iq,1314,2,1316,69
2/1/14,iq,1357,2,1359,67
2/2/14,iq,1357,4,1361,67
2/3/14,iq,1377,2,1379,66
2/4/14,iq,1315,3,1318,67
2/5/14,iq,1333,4,1337,66
2/6/14,iq,1289,8,1297,65
2/7/14,iq,1265,6,1271,63
2/8/14,iq,1278,4,1282,65
2/9/14,iq,1266,1,1267,66
2/10/14,iq,1289,2,1291,65
2/11/14,iq,1304,10,1314,66
2/12/14,iq,1332,5,1337,65
2/13/14,iq,1331,1,1332,65
2/14/14,iq,1323,2,1325,65
2/15/14,iq,1323,4,1327,65
2/16/14,iq,1252,3,1255,66
2/17/14,iq,1251,3,1254,65
2/18/14,iq,1265,2,1267,66
2/19/14,iq,1296,7,1303,67
2/20/14,iq,1304,22,1326,66
2/21/14,iq,1327,20,1347,66
2/22/14,iq,1333,7,1340,64
2/23/14,iq,1373,5,1378,65
2/24/14,iq,1296,4,1300,68
2/25/14,iq,1286,12,1298,68
2/26/14,iq,1320,8,1328,68
2/27/14,iq,1348,3,1351,68
2/28/14,iq,1322,2,1324,67
3/1/14,iq,1283,2,1285,63
3/2/14,iq,1223,2,1225,62
3/3/14,iq,1205,3,1208,64
3/4/14,iq,1262,6,1268,67
3/5/14,iq,1293,5,1298,66
3/6/14,iq,1298,8,1306,67
3/7/14,iq,1345,5,1350,66
3/8/14,iq,1371,4,1375,65
3/9/14,iq,1295,4,1299,65
3/10/14,iq,1314,2,1316,67
3/11/14,iq,1326,2,1328,66
3/12/14,iq,1369,2,1371,67
3/13/14,iq,1315,3,1318,68
3/14/14,iq,1264,4,1268,67
3/15/14,iq,1287,3,1290,67
3/16/14,iq,1278,4,1282,66
3/17/14,iq,1270,3,1273,66
3/18/14,iq,1264,4,1268,67
3/19/14,iq,1226,3,1229,67
3/20/14,iq,1236,5,1241,67
3/21/14,iq,1252,9,1261,67
3/22/14,iq,1307,8,1315,65
3/23/14,iq,1342,8,1350,65
3/24/14,iq,1277,8,1285,64
3/25/14,iq,1216,11,1227,70
3/26/14,iq,1186,10,1196,71
3/27/14,iq,1263,11,1274,67
3/28/14,iq,1254,8,1262,67
3/29/14,iq,1270,9,1279,66
3/30/14,iq,1219,8,1227,65
3/31/14,iq,1233,7,1240,65
4/1/14,iq,1227,5,1232,65
4/2/14,iq,1200,3,1203,65
4/3/14,iq,1189,3,1192,65
4/4/14,iq,1231,2,1233,64
4/5/14,iq,1279,4,1283,64
4/6/14,iq,1298,5,1303,66
4/7/14,iq,1331,8,1339,58
4/8/14,iq,1165,10,1175,52
4/9/14,iq,1112,7,1119,63
4/10/14,iq,1127,5,1132,65
4/11/14,iq,1175,3,1178,63
4/12/14,iq,1210,4,1214,64
4/13/14,iq,1211,5,1216,63
4/14/14,iq,1205,5,1210,64
4/15/14,iq,1190,8,1198,66
4/16/14,iq,1216,11,1227,65
4/17/14,iq,1221,11,1232,63
4/18/14,iq,953,11,964,77
4/19/14,iq,975,15,990,77
4/20/14,iq,984,16,1000,75
4/21/14,iq,979,12,991,75
4/22/14,iq,986,12,998,75
4/23/14,iq,997,11,1008,74
4/24/14,iq,1036,12,1048,72
4/25/14,iq,1041,18,1059,73
4/26/14,iq,1081,19,1100,71
4/27/14,iq,1088,18,1106,71
4/28/14,iq,1051,14,1065,73
4/29/14,iq,1050,18,1068,74
4/30/14,iq,1071,19,1090,74
5/1/14,iq,1120,22,1142,69
5/2/14,iq,1096,10,1106,69
5/3/14,iq,1097,18,1115,69
5/4/14,iq,1060,19,1079,69
5/5/14,iq,1037,16,1053,71
5/6/14,iq,1006,15,1021,72
5/7/14,iq,1007,17,1024,72
5/8/14,iq,1029,23,1052,70
5/9/14,iq,1004,20,1024,70
5/10/14,iq,1037,17,1054,71
5/11/14,iq,1063,17,1080,69
5/12/14,iq,1049,22,1071,71
5/13/14,iq,1064,19,1083,72
5/14/14,iq,1043,16,1059,68
5/15/14,iq,825,18,843,86
5/16/14,iq,1020,20,1040,73
5/17/14,iq,1090,22,1112,68
5/18/14,iq,1041,23,1064,70
5/19/14,iq,1048,20,1068,70
5/20/14,iq,1078,17,1095,72
5/21/14,iq,1115,15,1130,71
5/22/14,iq,1088,15,1103,71
5/23/14,iq,1066,19,1085,70
5/24/14,iq,1108,20,1128,69
5/25/14,iq,1089,13,1102,71
5/26/14,iq,1076,15,1091,71
5/27/14,iq,1055,15,1070,71
5/28/14,iq,1052,18,1070,70
5/29/14,iq,1044,19,1063,68
5/30/14,iq,991,15,1006,69
5/31/14,iq,1007,47,1054,68
6/1/14,iq,1050,105,1155,67
6/2/14,iq,1035,193,1228,67
6/3/14,iq,1034,197,1231,68
6/4/14,iq,1073,208,1281,68
6/5/14,iq,1082,268,1350,65
6/6/14,iq,1090,339,1429,66
6/7/14,iq,1101,387,1488,66
6/8/14,iq,1084,388,1472,67
6/9/14,iq,1068,397,1465,67
6/10/14,iq,1028,445,1473,65
6/11/14,iq,1040,433,1473,68
6/12/14,iq,1067,414,1481,67
6/13/14,iq,1783,367,2150,66
6/14/14,iq,4033,429,4462,65
6/15/14,iq,6792,476,7268,66
6/16/14,iq,8829,435,9264,67
6/17/14,iq,10498,295,10793,67
6/18/14,iq,12118,95,12213,68
6/19/14,iq,13368,81,13449,65
6/20/14,iq,15248,66,15314,65
6/21/14,iq,14032,52,14084,66
6/22/14,iq,13203,67,13270,66
6/23/14,iq,13998,389,14387,66
6/24/14,iq,14246,442,14688,68
6/25/14,iq,14329,493,14822,66
6/26/14,iq,14118,517,14635,67
6/27/14,iq,14170,502,14672,67
6/28/14,iq,14327,540,14867,67
6/29/14,iq,14045,544,14589,67
6/30/14,iq,10454,573,11027,68
7/1/14,iq,6235,475,6710,68
7/2/14,iq,4855,246,5101,68
7/3/14,iq,4353,550,4903,67
7/4/14,iq,4053,506,4559,66
7/5/14,iq,4211,527,4738,69
7/6/14,iq,9475,486,9961,68
7/7/14,iq,12864,449,13313,70
7/8/14,iq,12897,433,13330,73
7/9/14,iq,13896,436,14332,73
7/10/14,iq,13632,444,14076,72
7/11/14,iq,13485,447,13932,71
7/12/14,iq,13371,473,13844,69
7/13/14,iq,13491,511,14002,68
7/14/14,iq,12065,465,12530,75
7/15/14,iq,12913,454,13367,69
7/16/14,iq,12860,427,13287,70
7/17/14,iq,12595,400,12995,71
7/18/14,iq,13350,375,13725,68
7/19/14,iq,13165,355,13520,69
7/20/14,iq,12424,283,12707,70
7/21/14,iq,11259,343,11602,70
7/22/14,iq,10506,330,10836,71
7/23/14,iq,9893,281,10174,73
7/24/14,iq,10191,153,10344,69
7/25/14,iq,10296,126,10422,70
7/26/14,iq,10350,129,10479,69
7/27/14,iq,10065,121,10186,70
7/28/14,iq,9669,117,9786,69
7/29/14,iq,9294,82,9376,65
7/30/14,iq,9114,72,9186,66
7/31/14,iq,9287,79,9366,66
8/1/14,iq,9618,85,9703,68
8/2/14,iq,9651,71,9722,66
8/3/14,iq,9468,77,9545,68
8/4/14,iq,9508,59,9567,68
8/5/14,iq,8700,57,8757,68
8/6/14,iq,6836,57,6893,68
8/7/14,iq,6109,60,6169,67
8/8/14,iq,5992,52,6044,65
8/9/14,iq,5766,55,5821,66
8/10/14,iq,5879,43,5922,68
8/11/14,iq,4941,41,4982,68
8/12/14,iq,4520,36,4556,68
8/13/14,iq,4322,36,4358,68
8/14/14,iq,4202,32,4234,68
8/15/14,iq,4080,41,4121,68
8/16/14,iq,3891,37,3928,68
8/17/14,iq,3759,32,3791,65
8/18/14,iq,3683,42,3725,68
8/19/14,iq,3619,29,3648,69
8/20/14,iq,3640,30,3670,69
8/21/14,iq,3673,39,3712,68
8/22/14,iq,3248,37,3285,74
8/23/14,iq,3597,30,3627,67
8/24/14,iq,3523,27,3550,67
8/25/14,iq,3335,25,3360,68
8/26/14,iq,3216,31,3247,69
8/27/14,iq,3192,31,3223,69
8/28/14,iq,3178,27,3205,69
8/29/14,iq,3160,33,3193,68
8/30/14,iq,3206,24,3230,67
8/31/14,iq,3142,26,3168,68
9/1/14,iq,3068,31,3099,67
9/2/14,iq,3052,31,3083,67
9/3/14,iq,2969,31,3000,69
9/4/14,iq,3029,30,3059,68
9/5/14,iq,2978,33,3011,69
9/6/14,iq,3009,36,3045,68
9/7/14,iq,2981,25,3006,67
9/8/14,iq,2946,25,2971,68
9/9/14,iq,2844,30,2874,69
9/10/14,iq,2853,33,2886,68
9/11/14,iq,3006,27,3033,70
9/12/14,iq,2934,28,2962,68
9/13/14,iq,2791,29,2820,67
9/14/14,iq,2805,29,2834,68
9/15/14,iq,2838,27,2865,68
9/16/14,iq,2836,31,2867,68
9/17/14,iq,2741,30,2771,69
9/18/14,iq,2733,30,2763,69
9/19/14,iq,2746,29,2775,69
9/20/14,iq,2696,23,2719,69
9/21/14,iq,2730,27,2757,69
9/22/14,iq,2686,21,2707,69
9/23/14,iq,2681,21,2702,65
9/24/14,iq,2626,27,2653,64
9/25/14,iq,2474,29,2503,68
9/26/14,iq,2762,33,2795,66
9/27/14,iq,2856,33,2889,67
9/28/14,iq,2410,31,2441,70
9/29/14,iq,2447,27,2474,68
9/30/14,iq,2439,24,2463,69
10/1/14,iq,2409,26,2435,68
10/2/14,iq,2384,27,2411,69
10/3/14,iq,2321,29,2350,61
10/4/14,iq,1817,26,1843,61
10/6/14,iq,2179,28,2207,73
10/7/14,iq,2312,29,2341,69
10/8/14,iq,2377,27,2404,68
10/9/14,iq,2443,26,2469,68
10/10/14,iq,2423,25,2448,68
10/11/14,iq,2421,27,2448,67
10/12/14,iq,2464,23,2487,67
10/13/14,iq,2359,22,2381,68
10/14/14,iq,2431,21,2452,67
10/15/14,iq,2338,25,2363,67
10/16/14,iq,2354,24,2378,67
10/17/14,iq,2376,24,2400,67
10/18/14,iq,2245,23,2268,68
10/19/14,iq,2225,19,2244,67
10/20/14,iq,2261,22,2283,66
10/21/14,iq,2153,22,2175,66
10/22/14,iq,2141,24,2165,67
10/23/14,iq,2207,22,2229,67
10/24/14,iq,2229,35,2264,64
10/25/14,iq,2136,37,2173,65
10/26/14,iq,2103,28,2131,65
10/27/14,iq,2098,22,2120,65
10/28/14,iq,2043,23,2066,68
10/29/14,iq,2038,26,2064,68
10/30/14,iq,2100,22,2122,68
10/31/14,iq,2174,27,2201,68
11/1/14,iq,2206,27,2233,67
11/2/14,iq,2203,23,2226,66
11/3/14,iq,2119,22,2141,68
11/4/14,iq,2128,21,2149,67
11/5/14,iq,2068,25,2093,69
11/6/14,iq,2048,18,2066,67
11/7/14,iq,2033,18,2051,68
11/8/14,iq,2024,19,2043,66
11/9/14,iq,1947,20,1967,67
11/10/14,iq,1947,17,1964,67
11/11/14,iq,1946,17,1963,67
11/12/14,iq,1900,16,1916,67
11/13/14,iq,1921,20,1941,67
11/14/14,iq,1999,23,2022,68
11/15/14,iq,1985,24,2009,66
11/16/14,iq,1952,21,1973,66
11/17/14,iq,1926,18,1944,67
11/18/14,iq,1915,17,1932,68
11/19/14,iq,1898,20,1918,69
11/20/14,iq,1836,21,1857,71
11/21/14,iq,1836,24,1860,71
11/22/14,iq,1901,18,1919,67
11/23/14,iq,1889,13,1902,67
11/24/14,iq,1865,18,1883,68
11/25/14,iq,1834,19,1853,68
11/26/14,iq,1818,14,1832,68
11/27/14,iq,1959,17,1976,69
11/28/14,iq,1914,22,1936,69
11/29/14,iq,1881,24,1905,69
11/30/14,iq,1743,22,1765,68
12/1/14,iq,1706,24,1730,68
12/2/14,iq,1885,24,1909,68
12/3/14,iq,1811,20,1831,68
12/4/14,iq,1811,18,1829,67
12/5/14,iq,1871,24,1895,66
12/6/14,iq,1842,26,1868,67
12/7/14,iq,1810,22,1832,66
12/8/14,iq,1784,21,1805,66
12/9/14,iq,1797,22,1819,67
12/10/14,iq,1766,30,1796,67
12/11/14,iq,1744,30,1774,66
12/12/14,iq,1794,26,1820,67
12/13/14,iq,1829,23,1852,67
12/14/14,iq,1746,23,1769,66
12/15/14,iq,1655,23,1678,67
12/16/14,iq,1669,26,1695,66
12/17/14,iq,1697,25,1722,65
12/18/14,iq,1698,23,1721,67
12/19/14,iq,1768,23,1791,66
12/20/14,iq,1730,25,1755,66
12/21/14,iq,1623,22,1645,66
12/22/14,iq,1623,23,1646,67
12/23/14,iq,1644,21,1665,67
12/24/14,iq,1701,20,1721,67
12/25/14,iq,1851,15,1866,66
12/26/14,iq,1947,14,1961,58
12/27/14,iq,1545,17,1562,70
12/28/14,iq,1579,15,1594,68
12/29/14,iq,1574,17,1591,67
12/30/14,iq,1552,18,1570,67
12/31/14,iq,1557,16,1573,66
1/1/15,iq,1542,14,1556,66
1/2/15,iq,1501,19,1520,67
1/3/15,iq,1521,18,1539,66
1/4/15,iq,1580,19,1599,66
1/5/15,iq,1610,22,1632,65
1/6/15,iq,1623,20,1643,66
1/7/15,iq,1581,18,1599,66
1/8/15,iq,1602,20,1622,66
1/9/15,iq,1605,33,1638,65
1/10/15,iq,1422,21,1443,75
1/11/15,iq,1609,19,1628,66
1/12/15,iq,1501,20,1521,65
1/13/15,iq,1470,16,1486,67
1/14/15,iq,1437,48,1485,67
1/15/15,iq,1486,46,1532,66
1/16/15,iq,1557,52,1609,67
1/17/15,iq,1502,25,1527,70
1/18/15,iq,1550,22,1572,67
1/19/15,iq,1540,21,1561,67
1/20/15,iq,1658,24,1682,68
1/21/15,iq,1851,22,1873,67
1/22/15,iq,1655,18,1673,67
1/23/15,iq,1616,18,1634,66
1/24/15,iq,1582,17,1599,67
1/25/15,iq,1662,21,1683,67
1/26/15,iq,1708,19,1727,68
1/27/15,iq,1606,17,1623,67
1/28/15,iq,1558,18,1576,67
1/29/15,iq,1481,19,1500,68
1/30/15,iq,1448,14,1462,68
1/31/15,iq,1423,18,1441,68
2/1/15,iq,1464,18,1482,66
2/2/15,iq,1489,20,1509,67
2/3/15,iq,1515,18,1533,68
2/4/15,iq,1621,21,1642,68
2/5/15,iq,1514,19,1533,67
2/6/15,iq,1486,25,1511,67
2/7/15,iq,1486,19,1505,67
2/8/15,iq,1515,17,1532,66
2/9/15,iq,1504,20,1524,67
2/10/15,iq,1493,16,1509,67
2/11/15,iq,1495,16,1511,67
2/12/15,iq,1461,19,1480,67
2/13/15,iq,1456,47,1503,66
2/14/15,iq,1449,40,1489,67
2/15/15,iq,1431,42,1473,67
2/16/15,iq,1439,58,1497,67
2/17/15,iq,1391,61,1452,68
2/18/15,iq,1412,15,1427,68
2/19/15,iq,1418,12,1430,67
2/20/15,iq,1394,13,1407,67
2/21/15,iq,1410,13,1423,67
2/22/15,iq,1377,11,1388,67
2/23/15,iq,1380,14,1394,65
2/24/15,iq,1408,13,1421,67
2/25/15,iq,1402,17,1419,68
2/26/15,iq,1380,20,1400,67
2/27/15,iq,1379,14,1393,68
2/28/15,iq,1377,15,1392,68
3/1/15,iq,1401,17,1418,66
3/2/15,iq,1481,17,1498,67
3/3/15,iq,1490,15,1505,66
3/4/15,iq,1556,13,1569,66
3/5/15,iq,1899,14,1913,67
3/6/15,iq,2061,12,2073,67
3/7/15,iq,1785,14,1799,66
3/8/15,iq,1515,15,1530,66
3/9/15,iq,1723,9,1732,65
3/10/15,iq,1558,14,1572,65
3/11/15,iq,1439,12,1451,66
3/12/15,iq,1458,9,1467,65
3/13/15,iq,1456,11,1467,66
3/14/15,iq,1460,15,1475,66
3/15/15,iq,1457,16,1473,66
3/16/15,iq,1458,12,1470,66
3/17/15,iq,1421,14,1435,67
3/18/15,iq,1446,14,1460,66
3/19/15,iq,1446,10,1456,61
3/20/15,iq,1438,16,1454,63
3/21/15,iq,1472,18,1490,65
3/22/15,iq,1488,18,1506,65
3/23/15,iq,1446,14,1460,65
3/24/15,iq,1427,17,1444,65
3/25/15,iq,1436,21,1457,65
3/26/15,iq,1427,20,1447,66
3/27/15,iq,1469,21,1490,66
3/28/15,iq,1462,20,1482,68
3/29/15,iq,1406,19,1425,70
3/30/15,iq,1388,16,1404,69
3/31/15,iq,1462,18,1480,69
4/1/15,iq,1559,17,1576,67
4/2/15,iq,1644,17,1661,68
4/3/15,iq,1696,19,1715,68
4/4/15,iq,1695,16,1711,69
4/5/15,iq,1637,20,1657,69
4/6/15,iq,1637,16,1653,65
4/7/15,iq,1663,17,1680,65
4/8/15,iq,1556,16,1572,66
4/9/15,iq,1407,15,1422,67
4/10/15,iq,1353,18,1371,67
4/11/15,iq,1386,17,1403,67
4/12/15,iq,1401,14,1415,67
4/13/15,iq,1337,16,1353,68
4/14/15,iq,1309,18,1327,71
4/15/15,iq,1314,16,1330,70
4/16/15,iq,1324,16,1340,69
4/17/15,iq,1328,9,1337,70
4/18/15,iq,1338,12,1350,69
4/19/15,iq,1333,10,1343,70
4/20/15,iq,1322,10,1332,70
4/21/15,iq,1282,11,1293,69
4/22/15,iq,1246,12,1258,69
4/23/15,iq,1243,14,1257,70
4/24/15,iq,1261,14,1275,71
4/25/15,iq,1288,9,1297,70
4/26/15,iq,1292,15,1307,70
4/27/15,iq,1346,17,1363,70
4/28/15,iq,1280,13,1293,71
4/29/15,iq,1271,12,1283,71
4/30/15,iq,1278,17,1295,71
5/1/15,iq,1248,3,1251,70
5/2/15,iq,1249,15,1264,69
5/3/15,iq,1250,13,1263,69
5/4/15,iq,1257,10,1267,69
5/5/15,iq,1208,14,1222,69
5/6/15,iq,1200,13,1213,70
5/7/15,iq,1247,16,1263,69
5/8/15,iq,1382,18,1400,70
5/9/15,iq,1295,17,1312,70
5/10/15,iq,1232,15,1247,70
5/11/15,iq,1243,23,1266,70
5/12/15,iq,1286,20,1306,70
5/13/15,iq,1450,21,1471,67
5/14/15,iq,1427,26,1453,70
5/15/15,iq,1370,21,1391,69
5/16/15,iq,1541,20,1561,70
5/17/15,iq,1560,19,1579,70
5/18/15,iq,1338,17,1355,70
5/19/15,iq,1264,16,1280,70
5/20/15,iq,1232,19,1251,70
5/21/15,iq,1184,24,1208,71
5/22/15,iq,1198,22,1220,70
5/23/15,iq,1221,22,1243,71
5/24/15,iq,1239,24,1263,70
5/25/15,iq,1235,26,1261,69
5/26/15,iq,1258,26,1284,70
5/27/15,iq,1319,48,1367,68
5/28/15,iq,1311,33,1344,67
5/29/15,iq,1307,17,1324,66
5/30/15,iq,1300,20,1320,65
5/31/15,iq,1275,21,1296,66
6/1/15,iq,1251,23,1274,66
6/2/15,iq,1312,21,1333,66
6/3/15,iq,1339,21,1360,64
6/4/15,iq,1347,22,1369,65
6/5/15,iq,1304,20,1324,65
6/6/15,iq,1252,28,1280,66
6/7/15,iq,1252,26,1278,66
6/8/15,iq,1246,21,1267,64
6/9/15,iq,1279,21,1300,64
6/10/15,iq,1305,29,1334,64
6/11/15,iq,1340,27,1367,61
6/12/15,iq,1380,27,1407,62
6/13/15,iq,1317,19,1336,62
6/14/15,iq,1285,17,1302,63
6/15/15,iq,1271,23,1294,64
6/16/15,iq,1248,26,1274,64
6/17/15,iq,1235,30,1265,64
6/18/15,iq,1186,25,1211,64
6/19/15,iq,1174,28,1202,63
6/20/15,iq,1200,32,1232,63
6/21/15,iq,1274,23,1297,64
6/22/15,iq,1301,27,1328,64
6/23/15,iq,1353,31,1384,64
6/24/15,iq,1340,30,1370,64
6/25/15,iq,1296,27,1323,65
6/26/15,iq,1265,25,1290,64
6/27/15,iq,1300,27,1327,63
6/28/15,iq,1322,20,1342,63
6/29/15,iq,1335,17,1352,63
6/30/15,iq,1375,15,1390,63
7/1/15,iq,1322,22,1344,64
7/2/15,iq,1308,21,1329,64
7/3/15,iq,1394,24,1418,64
7/4/15,iq,1460,29,1489,63
7/5/15,iq,1417,32,1449,64
7/6/15,iq,1414,25,1439,64
7/7/15,iq,1337,32,1369,64
7/8/15,iq,1330,45,1375,64
7/9/15,iq,1389,48,1437,63
7/10/15,iq,1361,31,1392,63
7/11/15,iq,1342,29,1371,63
7/12/15,iq,1357,30,1387,64
7/13/15,iq,1319,42,1361,62
7/14/15,iq,1302,36,1338,63
7/15/15,iq,1282,32,1314,64
7/16/15,iq,1369,31,1400,63
7/17/15,iq,1353,29,1382,63
7/18/15,iq,1306,27,1333,64
7/19/15,iq,1282,24,1306,64
7/20/15,iq,1336,32,1368,63
7/21/15,iq,1359,16,1375,63
7/22/15,iq,1349,20,1369,63
7/23/15,iq,1321,20,1341,63
7/24/15,iq,1292,19,1311,63
7/25/15,iq,1289,19,1308,64
7/26/15,iq,1244,19,1263,65
7/27/15,iq,1281,14,1295,65
7/28/15,iq,1328,7,1335,65
7/29/15,iq,1333,16,1349,64
7/30/15,iq,1303,26,1329,64
7/31/15,iq,1310,21,1331,65
8/1/15,iq,1293,19,1312,63
8/2/15,iq,1342,21,1363,63
8/3/15,iq,1438,18,1456,63
8/4/15,iq,1412,17,1429,63
8/5/15,iq,1346,26,1372,64
8/6/15,iq,1361,25,1386,64
8/7/15,iq,1242,19,1261,63
8/8/15,iq,1227,18,1245,63
8/9/15,iq,1259,23,1282,63
8/10/15,iq,1249,20,1269,64
8/11/15,iq,1272,19,1291,64
8/12/15,iq,1257,26,1283,64
8/13/15,iq,1248,28,1276,63
8/14/15,iq,1274,20,1294,65
8/15/15,iq,1285,20,1305,64
8/16/15,iq,1289,22,1311,64
8/17/15,iq,1297,23,1320,64
8/18/15,iq,1321,20,1341,64
8/19/15,iq,1315,25,1340,65
8/20/15,iq,1307,23,1330,64
8/21/15,iq,1344,22,1366,64
8/22/15,iq,1348,17,1365,63
8/23/15,iq,1311,9,1320,63
8/24/15,iq,1285,13,1298,63
8/25/15,iq,1274,19,1293,64
8/26/15,iq,1307,24,1331,64
8/27/15,iq,1269,22,1291,64
8/28/15,iq,1257,18,1275,64
8/29/15,iq,1280,13,1293,64
8/30/15,iq,1282,13,1295,64
8/31/15,iq,1310,12,1322,65
9/1/15,iq,1296,13,1309,64
9/2/15,iq,1322,13,1335,64
9/3/15,iq,1304,12,1316,64
9/4/15,iq,1312,12,1324,63
9/5/15,iq,1299,9,1308,63
9/6/15,iq,1300,10,1310,63
9/7/15,iq,1358,10,1368,64
9/8/15,iq,1332,12,1344,64
9/9/15,iq,1270,12,1282,64
9/10/15,iq,1250,10,1260,64
9/11/15,iq,1264,13,1277,64
9/12/15,iq,1266,15,1281,65
9/13/15,iq,1232,13,1245,65
9/14/15,iq,1272,13,1285,65
9/15/15,iq,1279,9,1288,63
9/16/15,iq,1244,9,1253,65
9/17/15,iq,1248,9,1257,65
9/18/15,iq,1243,12,1255,64
9/19/15,iq,1247,12,1259,64
9/20/15,iq,1261,10,1271,64
9/21/15,iq,1261,13,1274,65
9/22/15,iq,1232,14,1246,65
9/23/15,iq,1231,12,1243,65
9/24/15,iq,1250,18,1268,64
9/25/15,iq,1266,17,1283,65
9/26/15,iq,1258,16,1274,64
9/27/15,iq,1181,13,1194,70
9/28/15,iq,1320,15,1335,65
9/29/15,iq,1317,13,1330,65
9/30/15,iq,1267,14,1281,66
10/1/15,iq,1286,14,1300,64
10/2/15,iq,1273,13,1286,64
10/3/15,iq,1247,11,1258,64
10/4/15,iq,1292,14,1306,64
10/5/15,iq,1298,18,1316,64
10/6/15,iq,1305,29,1334,63
10/7/15,iq,1247,26,1273,65
10/8/15,iq,1221,26,1247,65
10/9/15,iq,1247,18,1265,64
10/10/15,iq,1293,38,1331,64
10/11/15,iq,1255,37,1292,64
10/12/15,iq,1193,40,1233,59
10/13/15,iq,1243,22,1265,50
10/15/15,iq,1214,40,1254,65
10/16/15,iq,1191,46,1237,64
10/17/15,iq,1186,40,1226,65
10/18/15,iq,1156,23,1179,65
10/19/15,iq,1143,43,1186,65
10/20/15,iq,1177,43,1220,64
10/21/15,iq,1186,40,1226,65
10/22/15,iq,1213,41,1254,66
10/23/15,iq,1225,33,1258,66
10/24/15,iq,1273,21,1294,65
10/25/15,iq,1282,21,1303,65
10/26/15,iq,1210,23,1233,66
10/27/15,iq,1199,21,1220,66
10/28/15,iq,1148,22,1170,66
10/29/15,iq,1131,25,1156,66
10/30/15,iq,1154,24,1178,66
10/31/15,iq,1152,22,1174,67
11/1/15,iq,1194,18,1212,66
11/2/15,iq,1145,17,1162,66
11/3/15,iq,1096,20,1116,67
11/4/15,iq,1162,21,1183,65
11/5/15,iq,1197,20,1217,65
11/6/15,iq,1172,17,1189,65
11/7/15,iq,1149,20,1169,65
11/8/15,iq,1183,15,1198,65
11/9/15,iq,1194,19,1213,65
11/10/15,iq,1191,21,1212,63
11/11/15,iq,1140,21,1161,64
11/12/15,iq,1160,20,1180,65
11/13/15,iq,1193,17,1210,65
11/14/15,iq,1198,17,1215,66
11/15/15,iq,1129,18,1147,65
11/16/15,iq,1167,20,1187,65
11/17/15,iq,1079,14,1093,71
11/18/15,iq,1169,14,1183,65
11/19/15,iq,1140,15,1155,65
11/20/15,iq,1162,17,1179,65
11/21/15,iq,1134,16,1150,65
11/22/15,iq,1112,16,1128,63
11/23/15,iq,1124,17,1141,63
11/24/15,iq,1112,18,1130,63
11/25/15,iq,1117,22,1139,66
11/26/15,iq,1106,22,1128,66
11/27/15,iq,1120,21,1141,66
11/28/15,iq,1119,21,1140,66
11/29/15,iq,1146,21,1167,66
11/30/15,iq,1153,15,1168,67
12/1/15,iq,1174,18,1192,65
12/2/15,iq,1237,18,1255,65
12/3/15,iq,1151,20,1171,68
12/4/15,iq,1151,21,1172,64
12/5/15,iq,1121,23,1144,65
12/6/15,iq,1046,21,1067,64
12/7/15,iq,1032,23,1055,65
12/8/15,iq,1068,23,1091,65
12/9/15,iq,1082,28,1110,65
12/10/15,iq,1078,23,1101,64
12/11/15,iq,1095,20,1115,64
12/12/15,iq,1116,21,1137,63
12/13/15,iq,1094,24,1118,64
12/14/15,iq,1112,23,1135,64
12/15/15,iq,1110,19,1129,65
12/16/15,iq,1105,21,1126,65
12/17/15,iq,1114,23,1137,64
12/18/15,iq,1095,23,1118,62
12/19/15,iq,1048,32,1080,66
12/20/15,iq,1065,33,1098,65
12/21/15,iq,1060,36,1096,65
12/22/15,iq,1053,31,1084,66
12/23/15,iq,1089,35,1124,65
12/24/15,iq,1130,31,1161,65
12/25/15,iq,1093,35,1128,65
12/26/15,iq,1038,30,1068,66
12/27/15,iq,1017,30,1047,66
12/28/15,iq,1001,37,1038,66
12/29/15,iq,1051,29,1080,65
12/30/15,iq,1058,32,1090,63
12/31/15,iq,1037,40,1077,66
1/1/16,iq,1144,40,1184,64
1/2/16,iq,1105,37,1142,65
1/3/16,iq,1032,31,1063,64
1/4/16,iq,986,37,1023,67
1/5/16,iq,1092,47,1139,64
1/6/16,iq,1114,37,1151,64
1/7/16,iq,1102,34,1136,64
1/8/16,iq,1137,38,1175,65
1/9/16,iq,1164,43,1207,65
1/10/16,iq,1148,23,1171,64
1/11/16,iq,1072,35,1107,69
1/12/16,iq,1076,26,1102,70
1/13/16,iq,1062,27,1089,69
1/14/16,iq,1144,42,1186,64
1/15/16,iq,1115,50,1165,67
1/16/16,iq,1143,52,1195,64
1/17/16,iq,1100,50,1150,65
1/18/16,iq,1105,40,1145,65
1/19/16,iq,1121,49,1170,63
1/20/16,iq,1140,55,1195,65
1/21/16,iq,1161,54,1215,65
1/22/16,iq,1151,77,1228,64
1/23/16,iq,1162,68,1230,64
1/24/16,iq,1189,52,1241,63
1/25/16,iq,1229,61,1290,65
1/26/16,iq,1158,67,1225,68
1/27/16,iq,1080,58,1138,69
1/28/16,iq,1049,46,1095,69
1/29/16,iq,1067,36,1103,65
1/30/16,iq,1046,50,1096,65
1/31/16,iq,1122,50,1172,65
2/1/16,iq,1185,39,1224,65
2/2/16,iq,1154,39,1193,66
2/3/16,iq,1062,39,1101,70
2/4/16,iq,1069,37,1106,70
2/5/16,iq,1096,36,1132,70
2/6/16,iq,1130,43,1173,71
2/7/16,iq,1141,41,1182,71
2/8/16,iq,1155,28,1183,70
2/9/16,iq,1165,28,1193,70
2/10/16,iq,1108,43,1151,71
2/11/16,iq,1102,33,1135,71
2/12/16,iq,1081,35,1116,70
2/13/16,iq,1169,40,1209,69
2/14/16,iq,1068,37,1105,69
2/15/16,iq,1071,41,1112,69
2/16/16,iq,1067,50,1117,68
2/17/16,iq,1054,33,1087,68
2/18/16,iq,1040,31,1071,69
2/19/16,iq,1061,29,1090,70
2/20/16,iq,1052,30,1082,71
2/21/16,iq,1080,33,1113,70
2/22/16,iq,1052,32,1084,69
2/23/16,iq,1019,42,1061,70
2/24/16,iq,1038,41,1079,71
2/25/16,iq,1075,43,1118,70
2/26/16,iq,1108,38,1146,70
2/27/16,iq,1082,39,1121,71
2/28/16,iq,1106,44,1150,71
2/29/16,iq,1096,38,1134,71
3/1/16,iq,1054,36,1090,69
3/2/16,iq,1097,46,1143,67
3/3/16,iq,1074,43,1117,70
3/4/16,iq,1061,36,1097,70
3/5/16,iq,1067,37,1104,71
3/6/16,iq,1072,39,1111,70
3/7/16,iq,1118,52,1170,66
3/8/16,iq,1016,49,1065,71
3/9/16,iq,1004,45,1049,71
3/10/16,iq,1075,52,1127,70
3/11/16,iq,1183,36,1219,71
3/12/16,iq,1249,40,1289,71
3/13/16,iq,1238,48,1286,71
3/14/16,iq,1234,37,1271,70
3/15/16,iq,1212,41,1253,71
3/16/16,iq,1178,46,1224,71
3/17/16,iq,1191,44,1235,68
3/18/16,iq,1258,43,1301,62
3/19/16,iq,1307,37,1344,70
3/20/16,iq,1237,38,1275,71
3/21/16,iq,1187,35,1222,71
3/22/16,iq,1181,38,1219,71
3/23/16,iq,1205,43,1248,71
3/24/16,iq,1157,40,1197,69
3/25/16,iq,1159,38,1197,70
3/26/16,iq,1135,34,1169,72
3/27/16,iq,1135,38,1173,71
3/28/16,iq,1168,42,1210,71
3/29/16,iq,1172,32,1204,71
3/30/16,iq,1126,33,1159,70
3/31/16,iq,1086,42,1128,68
4/1/16,iq,1107,40,1147,71
4/2/16,iq,1084,38,1122,70
4/3/16,iq,1070,37,1107,71
4/4/16,iq,1079,36,1115,71
4/5/16,iq,1109,31,1140,71
4/6/16,iq,1083,27,1110,70
4/7/16,iq,1103,25,1128,70
4/8/16,iq,1132,29,1161,70
4/9/16,iq,1117,30,1147,71
4/10/16,iq,1101,35,1136,71
4/11/16,iq,1061,33,1094,71
4/12/16,iq,1044,37,1081,71
4/13/16,iq,1042,38,1080,71
4/14/16,iq,1056,36,1092,72
4/15/16,iq,1039,46,1085,71
4/16/16,iq,1036,52,1088,71
4/17/16,iq,1044,55,1099,72
4/18/16,iq,1111,55,1166,70
4/19/16,iq,1110,56,1166,70
4/20/16,iq,1066,53,1119,70
4/21/16,iq,1023,53,1076,71
4/22/16,iq,985,47,1032,72
4/23/16,iq,980,47,1027,71
4/24/16,iq,977,48,1025,70
4/25/16,iq,993,48,1041,70
4/26/16,iq,996,41,1037,70
4/27/16,iq,981,40,1021,71
4/28/16,iq,1009,38,1047,71
4/29/16,iq,1048,34,1082,69
4/30/16,iq,1062,35,1097,67
5/1/16,iq,1068,31,1099,70
5/2/16,iq,1036,38,1074,70
5/3/16,iq,1015,38,1053,69
5/4/16,iq,1017,37,1054,69
5/5/16,iq,1010,39,1049,70
5/6/16,iq,1061,42,1103,69
5/7/16,iq,1144,51,1195,71
5/8/16,iq,1121,47,1168,71
5/9/16,iq,1121,54,1175,71
5/10/16,iq,1044,68,1112,70
5/11/16,iq,997,58,1055,70
5/12/16,iq,944,40,984,72
5/13/16,iq,1020,37,1057,71
5/14/16,iq,1057,38,1095,71
5/15/16,iq,954,43,997,71
5/16/16,iq,1069,44,1113,71
5/17/16,iq,1044,43,1087,70
5/18/16,iq,1020,41,1061,71
5/19/16,iq,945,40,985,71
5/20/16,iq,995,52,1047,71
5/21/16,iq,1030,48,1078,72
5/22/16,iq,1010,46,1056,72
5/23/16,iq,1001,48,1049,72
5/24/16,iq,1085,53,1138,71
5/25/16,iq,1113,42,1155,72
5/26/16,iq,1079,50,1129,70
5/27/16,iq,1357,53,1410,72
5/28/16,iq,1327,54,1381,73
5/29/16,iq,1244,47,1291,72
5/30/16,iq,1105,45,1150,71
5/31/16,iq,1089,52,1141,72
6/1/16,iq,1084,46,1130,70
6/2/16,iq,1053,47,1100,71
6/3/16,iq,1086,36,1122,70
6/4/16,iq,1036,35,1071,69
6/5/16,iq,1034,41,1075,70
6/6/16,iq,1018,37,1055,70
6/7/16,iq,1042,37,1079,70
6/8/16,iq,1070,51,1121,70
6/9/16,iq,1072,57,1129,70
6/10/16,iq,1092,51,1143,70
6/11/16,iq,1198,55,1253,70
6/12/16,iq,1219,61,1280,71
6/13/16,iq,1173,59,1232,71
6/14/16,iq,1119,54,1173,71
6/15/16,iq,1137,55,1192,71
6/16/16,iq,1155,61,1216,71
6/17/16,iq,1135,66,1201,71
6/18/16,iq,1115,63,1178,71
6/19/16,iq,1135,68,1203,71
6/20/16,iq,1094,65,1159,72
6/21/16,iq,1191,57,1248,73
6/22/16,iq,1156,55,1211,72
6/23/16,iq,1056,54,1110,70
6/24/16,iq,1061,52,1113,70
6/25/16,iq,1052,53,1105,70
6/26/16,iq,1041,49,1090,71
6/27/16,iq,1027,45,1072,71
6/28/16,iq,1008,46,1054,69
6/29/16,iq,988,46,1034,70
6/30/16,iq,1017,53,1070,71
7/1/16,iq,991,50,1041,70
7/2/16,iq,989,48,1037,69
7/3/16,iq,1033,48,1081,70
7/4/16,iq,1027,54,1081,69
7/5/16,iq,1045,47,1092,70
7/6/16,iq,1015,44,1059,72
7/7/16,iq,999,51,1050,72
7/8/16,iq,1026,47,1073,73
7/9/16,iq,1019,55,1074,71
7/10/16,iq,1021,54,1075,71
7/11/16,iq,1034,59,1093,72
7/12/16,iq,1043,51,1094,71
7/13/16,iq,1046,55,1101,72
7/14/16,iq,1023,54,1077,72
7/15/16,iq,1018,55,1073,71
7/16/16,iq,1035,49,1084,72
7/17/16,iq,1049,55,1104,72
7/18/16,iq,1100,53,1153,72
7/19/16,iq,1025,49,1074,71
7/20/16,iq,991,52,1043,72
7/21/16,iq,999,49,1048,72
7/22/16,iq,1013,51,1064,72
7/23/16,iq,1011,58,1069,72
7/24/16,iq,1041,49,1090,72
7/25/16,iq,1026,48,1074,72
7/26/16,iq,1017,46,1063,71
7/27/16,iq,1006,41,1047,71
7/28/16,iq,1012,50,1062,72
7/29/16,iq,1042,45,1087,71
7/30/16,iq,1032,68,1100,72
7/31/16,iq,1023,54,1077,72
8/1/16,iq,1046,46,1092,72
8/2/16,iq,1052,42,1094,70
8/3/16,iq,1034,44,1078,69
8/4/16,iq,1038,48,1086,70
8/5/16,iq,1052,50,1102,71
8/6/16,iq,1043,51,1094,72
8/7/16,iq,1074,53,1127,73
8/8/16,iq,1052,45,1097,72
8/9/16,iq,1035,51,1086,73
8/10/16,iq,1058,63,1121,74
8/11/16,iq,1015,31,1046,74
8/12/16,iq,1002,25,1027,74
8/13/16,iq,1025,37,1062,74
8/14/16,iq,1023,44,1067,74
8/15/16,iq,990,51,1041,74
8/16/16,iq,976,41,1017,75
8/17/16,iq,997,27,1024,74
8/18/16,iq,1023,29,1052,72
8/19/16,iq,1027,31,1058,74
8/20/16,iq,1037,27,1064,75
8/21/16,iq,1000,31,1031,75
8/22/16,iq,971,28,999,75
8/23/16,iq,983,24,1007,75
8/24/16,iq,1003,25,1028,76
8/25/16,iq,1032,32,1064,75
8/26/16,iq,1019,31,1050,76
8/27/16,iq,1006,29,1035,76
8/28/16,iq,996,39,1035,76
8/29/16,iq,986,30,1016,76
8/30/16,iq,1012,26,1038,77
8/31/16,iq,1035,29,1064,76
9/1/16,iq,998,34,1032,77
9/2/16,iq,1052,29,1081,77
9/3/16,iq,1018,27,1045,78
9/4/16,iq,974,20,994,75
9/5/16,iq,998,24,1022,75
9/6/16,iq,987,24,1011,77
9/7/16,iq,977,33,1010,78
9/8/16,iq,962,29,991,78
9/9/16,iq,956,29,985,78
9/10/16,iq,964,31,995,78
9/11/16,iq,973,33,1006,78
9/12/16,iq,961,32,993,78
9/13/16,iq,1015,28,1043,78
9/14/16,iq,1060,30,1090,77
9/15/16,iq,1032,25,1057,77
9/16/16,iq,1052,25,1077,78
9/17/16,iq,1048,25,1073,78
9/19/16,iq,984,30,1014,78
9/20/16,iq,998,27,1025,79
9/21/16,iq,1014,30,1044,79
9/22/16,iq,1012,28,1040,77
9/23/16,iq,1015,33,1048,76
9/24/16,iq,1036,25,1061,76
9/25/16,iq,1051,33,1084,77
9/26/16,iq,1055,32,1087,77
9/27/16,iq,1061,33,1094,78
9/28/16,iq,1108,32,1140,78
9/29/16,iq,1014,32,1046,79
9/30/16,iq,1000,29,1029,80
10/1/16,iq,972,28,1000,80
10/2/16,iq,997,27,1024,79
10/3/16,iq,986,26,1012,79
10/4/16,iq,976,30,1006,79
10/5/16,iq,979,31,1010,78
10/6/16,iq,970,34,1004,78
10/7/16,iq,968,28,996,79
10/8/16,iq,944,28,972,79
10/9/16,iq,961,30,991,80
10/10/16,iq,1015,33,1048,80
10/11/16,iq,1052,31,1083,80
10/12/16,iq,1024,28,1052,79
10/13/16,iq,1035,26,1061,79
10/14/16,iq,1014,26,1040,79
10/15/16,iq,979,26,1005,79
10/16/16,iq,974,32,1006,78
10/17/16,iq,1015,31,1046,73
10/18/16,iq,990,31,1021,72
10/19/16,iq,990,31,1021,76
10/20/16,iq,1010,28,1038,77
10/21/16,iq,1028,33,1061,76
10/22/16,iq,1027,26,1053,79
10/23/16,iq,1009,29,1038,78
10/24/16,iq,1018,25,1043,78
10/25/16,iq,1018,32,1050,78
10/26/16,iq,1002,33,1035,78
10/27/16,iq,1010,31,1041,79
10/28/16,iq,1034,35,1069,79
10/29/16,iq,1020,35,1055,80
10/30/16,iq,989,35,1024,80
10/31/16,iq,974,35,1009,81
11/1/16,iq,980,33,1013,80
11/2/16,iq,997,29,1026,81
11/3/16,iq,1016,34,1050,80
11/4/16,iq,1002,42,1044,80
11/5/16,iq,983,30,1013,80
11/6/16,iq,995,33,1028,81
11/7/16,iq,966,35,1001,80
11/8/16,iq,970,41,1011,80
11/9/16,iq,974,39,1013,81
11/10/16,iq,1018,34,1052,79
11/11/16,iq,1051,33,1084,80
11/12/16,iq,1068,34,1102,80
11/13/16,iq,1044,30,1074,81
11/14/16,iq,1051,34,1085,80
11/15/16,iq,1084,69,1153,80
11/16/16,iq,1075,96,1171,80
11/17/16,iq,1060,59,1119,80
11/18/16,iq,1038,52,1090,80
11/19/16,iq,1061,43,1104,81
11/20/16,iq,1057,36,1093,80
11/21/16,iq,1016,37,1053,80
11/22/16,iq,989,44,1033,80
11/23/16,iq,951,49,1000,81
11/24/16,iq,954,38,992,81
11/25/16,iq,961,32,993,80
11/26/16,iq,914,29,943,80
11/27/16,iq,920,34,954,80
11/28/16,iq,940,32,972,80
11/29/16,iq,965,31,996,81
11/30/16,iq,940,34,974,81
12/1/16,iq,980,39,1019,80
12/2/16,iq,1014,40,1054,80
12/3/16,iq,935,44,979,79
12/4/16,iq,883,33,916,79
12/5/16,iq,861,33,894,79
12/6/16,iq,866,27,893,80
12/7/16,iq,902,33,935,80
12/8/16,iq,906,31,937,81
12/9/16,iq,930,34,964,80
12/10/16,iq,913,34,947,80
12/11/16,iq,897,35,932,80
12/12/16,iq,906,39,945,80
12/13/16,iq,917,37,954,81
12/14/16,iq,903,39,942,80
12/15/16,iq,906,37,943,80
12/16/16,iq,924,41,965,81
12/17/16,iq,920,38,958,80
12/18/16,iq,876,34,910,81
12/19/16,iq,915,35,950,78
12/20/16,iq,885,34,919,75
12/21/16,iq,857,33,890,80
12/22/16,iq,838,38,876,80
12/23/16,iq,876,34,910,81
12/24/16,iq,898,32,930,81
12/25/16,iq,809,33,842,81
12/26/16,iq,885,30,915,82
12/27/16,iq,832,33,865,82
12/28/16,iq,753,35,788,81
12/29/16,iq,862,36,898,81
12/30/16,iq,917,32,949,81
12/31/16,iq,886,27,913,82
1/1/17,iq,903,32,935,81
1/2/17,iq,884,34,918,81
1/3/17,iq,913,28,941,81
1/4/17,iq,882,27,909,82
1/5/17,iq,872,35,907,82
1/6/17,iq,892,39,931,81
1/7/17,iq,924,34,958,81
1/8/17,iq,904,34,938,82
1/9/17,iq,927,27,954,82
1/10/17,iq,978,26,1004,82
1/11/17,iq,932,37,969,81
1/12/17,iq,941,38,979,81
1/13/17,iq,998,41,1039,82
1/14/17,iq,999,35,1034,81
1/15/17,iq,998,41,1039,82
1/16/17,iq,1015,30,1045,82
1/17/17,iq,1021,34,1055,82
1/18/17,iq,983,36,1019,81
1/19/17,iq,983,35,1018,81
1/20/17,iq,1006,35,1041,82
1/21/17,iq,999,37,1036,82
1/22/17,iq,969,42,1011,82
1/23/17,iq,970,39,1009,76
1/24/17,iq,995,37,1032,80
1/25/17,iq,1026,33,1059,81
1/26/17,iq,1010,36,1046,81
1/27/17,iq,1000,40,1040,81
1/28/17,iq,1038,41,1079,81
1/29/17,iq,1042,44,1086,81
1/30/17,iq,1026,44,1070,82
1/31/17,iq,1043,47,1090,82
2/1/17,iq,1096,54,1150,81
2/2/17,iq,1084,44,1128,82
2/3/17,iq,1084,41,1125,82
2/4/17,iq,1075,42,1117,81
2/5/17,iq,1099,44,1143,81
2/6/17,iq,1062,39,1101,82
2/7/17,iq,1098,43,1141,81
2/8/17,iq,1088,41,1129,82
2/9/17,iq,1101,37,1138,82
2/10/17,iq,1098,44,1142,82
2/11/17,iq,1095,44,1139,82
2/12/17,iq,1160,36,1196,82
2/13/17,iq,1148,36,1184,82
2/14/17,iq,1165,38,1203,81
2/15/17,iq,1099,44,1143,80
2/16/17,iq,1092,43,1135,82
2/17/17,iq,1083,40,1123,82
2/18/17,iq,1071,44,1115,81
2/19/17,iq,1027,39,1066,81
2/20/17,iq,1033,52,1085,81
2/21/17,iq,1021,39,1060,81
2/22/17,iq,1025,35,1060,80
2/23/17,iq,1047,42,1089,80
2/24/17,iq,1084,40,1124,81
2/25/17,iq,1095,42,1137,81
2/26/17,iq,1016,39,1055,80
2/27/17,iq,1020,40,1060,81
2/28/17,iq,972,38,1010,83
3/1/17,iq,963,36,999,79
3/2/17,iq,999,42,1041,81
3/3/17,iq,1006,39,1045,82
3/4/17,iq,1004,29,1033,80
3/5/17,iq,961,37,998,80
3/6/17,iq,984,37,1021,81
3/7/17,iq,1009,36,1045,81
3/8/17,iq,999,47,1046,78
3/9/17,iq,997,42,1039,79
3/10/17,iq,1003,32,1035,81
3/11/17,iq,1038,27,1065,83
3/12/17,iq,1021,31,1052,82
3/13/17,iq,996,34,1030,81
3/14/17,iq,969,29,998,81
3/15/17,iq,983,28,1011,82
3/16/17,iq,1011,34,1045,82
3/17/17,iq,988,39,1027,81
3/18/17,iq,999,30,1029,82
3/19/17,iq,987,35,1022,82
3/20/17,iq,960,35,995,81
3/21/17,iq,1037,30,1067,80
3/22/17,iq,996,25,1021,80
3/23/17,iq,1000,29,1029,82
3/24/17,iq,1016,31,1047,82
3/25/17,iq,979,36,1015,82
3/26/17,iq,932,42,974,82
3/27/17,iq,962,41,1003,80
3/28/17,iq,969,40,1009,81
3/29/17,iq,962,40,1002,80
3/30/17,iq,948,42,990,81
3/31/17,iq,1014,40,1054,78
4/1/17,iq,1073,41,1114,74
4/2/17,iq,999,35,1034,78
4/3/17,iq,950,33,983,80
4/4/17,iq,973,32,1005,77
4/5/17,iq,981,30,1011,78
4/6/17,iq,1002,23,1025,79
4/7/17,iq,979,25,1004,81
4/8/17,iq,958,27,985,81
4/9/17,iq,958,39,997,81
4/10/17,iq,1044,42,1086,74
4/11/17,iq,984,46,1030,79
4/12/17,iq,956,51,1007,81
4/13/17,iq,941,41,982,82
4/14/17,iq,958,49,1007,82
4/15/17,iq,917,51,968,82
4/16/17,iq,928,50,978,82
4/17/17,iq,920,57,977,82
4/18/17,iq,932,60,992,82
4/19/17,iq,934,48,982,83
4/20/17,iq,954,49,1003,83
4/21/17,iq,962,25,987,83
4/22/17,iq,962,39,1001,83
4/23/17,iq,979,42,1021,82
4/24/17,iq,993,43,1036,82
4/25/17,iq,982,50,1032,81
4/26/17,iq,962,42,1004,81
4/27/17,iq,950,43,993,80
4/28/17,iq,957,51,1008,82
4/29/17,iq,917,48,965,82
4/30/17,iq,870,48,918,82
5/1/17,iq,861,41,902,81
5/2/17,iq,855,35,890,80
5/3/17,iq,869,39,908,82
5/4/17,iq,878,33,911,82
5/5/17,iq,973,26,999,73
5/6/17,iq,894,28,922,62
5/8/17,iq,878,40,918,81
5/9/17,iq,883,50,933,82
5/10/17,iq,871,44,915,83
5/11/17,iq,860,33,893,83
5/12/17,iq,847,30,877,83
5/13/17,iq,858,32,890,83
5/14/17,iq,886,28,914,82
5/15/17,iq,891,25,916,81
5/16/17,iq,852,26,878,81
5/17/17,iq,881,39,920,82
5/18/17,iq,888,44,932,82
5/19/17,iq,885,42,927,81
5/20/17,iq,864,47,911,81
5/21/17,iq,894,44,938,83
5/22/17,iq,896,43,939,83
5/23/17,iq,912,58,970,79
5/24/17,iq,925,52,977,81
5/25/17,iq,869,53,922,82
5/26/17,iq,871,62,933,82
5/27/17,iq,869,52,921,83
5/28/17,iq,857,47,904,82
5/29/17,iq,884,48,932,83
5/30/17,iq,865,40,905,83
5/31/17,iq,876,38,914,83
6/1/17,iq,804,31,835,92
6/2/17,iq,876,36,912,84
6/3/17,iq,884,38,922,83
6/4/17,iq,895,38,933,83
6/5/17,iq,879,39,918,84
6/6/17,iq,862,43,905,84
6/7/17,iq,903,40,943,83
6/8/17,iq,900,30,930,82
6/9/17,iq,943,34,977,81
6/10/17,iq,938,26,964,79
6/11/17,iq,1001,26,1027,77
6/12/17,iq,939,21,960,81
6/13/17,iq,897,21,918,83
6/14/17,iq,907,26,933,82
6/15/17,iq,877,28,905,81
6/16/17,iq,907,29,936,83
6/17/17,iq,897,35,932,83
6/18/17,iq,907,34,941,82
6/19/17,iq,879,32,911,83
6/20/17,iq,881,27,908,80
6/21/17,iq,880,29,909,83
6/22/17,iq,887,22,909,84
6/23/17,iq,972,24,996,83
6/24/17,iq,924,30,954,84
6/25/17,iq,957,27,984,83
6/26/17,iq,961,19,980,83
6/27/17,iq,927,22,949,83
6/28/17,iq,923,25,948,83
6/29/17,iq,921,32,953,83
6/30/17,iq,954,32,986,85
7/1/17,iq,994,34,1028,83
7/2/17,iq,1016,24,1040,81
7/3/17,iq,1124,24,1148,83
7/4/17,iq,1121,24,1145,83
7/5/17,iq,1043,25,1068,84
7/6/17,iq,1066,29,1095,83
7/7/17,iq,1122,30,1152,83
7/8/17,iq,1084,28,1112,84
7/9/17,iq,1038,26,1064,78
7/10/17,iq,1126,42,1168,66
7/12/17,iq,1073,38,1111,83
7/13/17,iq,1058,32,1090,84
7/14/17,iq,1063,39,1102,83
7/15/17,iq,1041,26,1067,83
7/16/17,iq,1090,30,1120,84
7/17/17,iq,1083,23,1106,84
7/18/17,iq,1075,25,1100,85
7/19/17,iq,1084,24,1108,83
7/20/17,iq,1102,28,1130,85
7/21/17,iq,1140,24,1164,85
7/22/17,iq,1107,26,1133,85
7/23/17,iq,1105,26,1131,85
7/24/17,iq,1131,24,1155,84
7/25/17,iq,1074,23,1097,84
7/26/17,iq,1089,22,1111,85
7/27/17,iq,1103,29,1132,86
7/28/17,iq,1120,20,1140,85
7/29/17,iq,1118,21,1139,86
7/30/17,iq,1218,28,1246,85
7/31/17,iq,1125,23,1148,87
8/1/17,iq,1137,23,1160,84
8/2/17,iq,1128,31,1159,85
8/3/17,iq,1149,33,1182,85
8/4/17,iq,1184,29,1213,85
8/5/17,iq,1140,30,1170,85
8/6/17,iq,1124,28,1152,85
8/7/17,iq,1115,26,1141,83
8/8/17,iq,1140,23,1163,83
8/9/17,iq,1184,20,1204,83
8/10/17,iq,1180,26,1206,85
8/11/17,iq,1181,25,1206,84
8/12/17,iq,1176,26,1202,83
8/13/17,iq,1156,28,1184,82
8/14/17,iq,1150,21,1171,83
8/15/17,iq,1167,20,1187,83
8/16/17,iq,1163,26,1189,85
8/17/17,iq,1334,36,1370,86
8/18/17,iq,1447,31,1478,84
8/19/17,iq,1381,30,1411,85
8/20/17,iq,1335,28,1363,85
8/21/17,iq,1314,30,1344,85
8/22/17,iq,1287,22,1309,84
8/23/17,iq,1314,30,1344,84
8/24/17,iq,1338,30,1368,86
8/25/17,iq,1324,34,1358,85
8/26/17,iq,1312,25,1337,83
8/27/17,iq,1319,26,1345,82
8/28/17,iq,1310,18,1328,83
8/29/17,iq,1337,23,1360,79
8/30/17,iq,1427,31,1458,76
8/31/17,iq,1402,26,1428,77
9/1/17,iq,1475,27,1502,76
9/2/17,iq,1499,19,1518,77
9/3/17,iq,1514,14,1528,76
9/4/17,iq,1449,20,1469,78
9/5/17,iq,1341,27,1368,83
9/6/17,iq,1369,25,1394,81
9/7/17,iq,1400,23,1423,76
9/8/17,iq,1457,20,1477,77
9/9/17,iq,1451,26,1477,77
9/10/17,iq,1510,31,1541,76
9/11/17,iq,1476,33,1509,77
9/12/17,iq,1440,23,1463,78
9/13/17,iq,1346,20,1366,83
9/14/17,iq,1409,26,1435,82
9/15/17,iq,1501,27,1528,77
9/16/17,iq,1611,16,1627,77
9/17/17,iq,1412,12,1424,82
9/18/17,iq,1346,13,1359,86
9/19/17,iq,1397,15,1412,85
9/20/17,iq,1440,14,1454,83
9/21/17,iq,1405,16,1421,84
9/22/17,iq,1423,13,1436,84
9/23/17,iq,1453,14,1467,85
9/24/17,iq,1422,15,1437,85
9/25/17,iq,1395,18,1413,84
9/26/17,iq,1385,20,1405,84
9/27/17,iq,1399,17,1416,86
9/28/17,iq,1412,15,1427,82
9/29/17,iq,1375,16,1391,85
9/30/17,iq,1347,16,1363,85
10/1/17,iq,1342,14,1356,83
10/2/17,iq,1296,14,1310,84
10/3/17,iq,1292,16,1308,84
10/4/17,iq,1464,16,1480,75
10/5/17,iq,1475,15,1490,76
10/6/17,iq,1366,16,1382,83
10/7/17,iq,1308,19,1327,84
10/8/17,iq,1277,18,1295,83
10/9/17,iq,1253,18,1271,85
10/10/17,iq,1281,24,1305,84
10/11/17,iq,1261,24,1285,83
10/12/17,iq,1307,22,1329,85
10/13/17,iq,1506,25,1531,80
10/14/17,iq,1492,20,1512,80
10/15/17,iq,1394,14,1408,80
10/16/17,iq,1337,19,1356,81
10/17/17,iq,1330,23,1353,81
10/18/17,iq,1350,22,1372,82
10/19/17,iq,1476,20,1496,78
10/20/17,iq,1425,22,1447,82
10/21/17,iq,1468,18,1486,79
10/22/17,iq,1431,21,1452,78
10/23/17,iq,1283,23,1306,85
10/24/17,iq,1340,16,1356,84
10/25/17,iq,1348,14,1362,84
10/26/17,iq,1384,16,1400,81
10/27/17,iq,1413,12,1425,79
10/28/17,iq,1368,12,1380,82
10/29/17,iq,1316,15,1331,82
10/30/17,iq,1362,22,1384,80
10/31/17,iq,1354,17,1371,78
11/1/17,iq,1313,20,1333,81
11/2/17,iq,1333,21,1354,80
11/3/17,iq,1339,21,1360,77
11/4/17,iq,1321,19,1340,79
11/5/17,iq,1282,14,1296,81
11/6/17,iq,1209,14,1223,81
11/7/17,iq,1260,13,1273,80
11/8/17,iq,1369,15,1384,75
11/9/17,iq,1301,13,1314,80
11/10/17,iq,1284,13,1297,84
11/11/17,iq,1214,13,1227,83
11/12/17,iq,1139,12,1151,86
11/13/17,iq,1131,11,1142,85
11/14/17,iq,1158,11,1169,86
11/15/17,iq,1148,10,1158,86
11/16/17,iq,1160,10,1170,86
11/17/17,iq,1164,8,1172,86
11/18/17,iq,1140,9,1149,85
11/19/17,iq,1103,11,1114,87
11/20/17,iq,1107,11,1118,85
11/21/17,iq,1147,13,1160,82
11/22/17,iq,1173,11,1184,82
11/23/17,iq,1149,14,1163,85
11/24/17,iq,1161,12,1173,84
11/25/17,iq,1122,11,1133,86
11/26/17,iq,1094,10,1104,86
11/27/17,iq,1075,10,1085,86
11/28/17,iq,1052,14,1066,88
11/29/17,iq,1143,13,1156,85
11/30/17,iq,1158,12,1170,88
12/1/17,iq,1217,11,1228,82
12/2/17,iq,1221,13,1234,79
12/3/17,iq,1127,12,1139,83
12/4/17,iq,1122,11,1133,83
12/5/17,iq,1130,13,1143,85
12/6/17,iq,1139,13,1152,84
12/7/17,iq,1136,14,1150,86
12/8/17,iq,1152,12,1164,85
12/9/17,iq,1162,15,1177,85
12/10/17,iq,1163,15,1178,83
12/11/17,iq,1090,13,1103,82
12/12/17,iq,1101,10,1111,82
12/13/17,iq,1073,12,1085,82
12/14/17,iq,1064,14,1078,81
12/15/17,iq,1076,19,1095,78
12/16/17,iq,1119,23,1142,82
12/17/17,iq,1080,17,1097,82
12/18/17,iq,1060,18,1078,82
12/19/17,iq,1138,18,1156,78
12/20/17,iq,1069,20,1089,83
12/21/17,iq,1082,22,1104,83
12/22/17,iq,1087,23,1110,85
12/23/17,iq,1062,24,1086,87
12/24/17,iq,1106,28,1134,86
12/25/17,iq,1162,25,1187,86
12/26/17,iq,1043,26,1069,86
12/27/17,iq,1070,33,1103,86
12/28/17,iq,1097,27,1124,82
12/29/17,iq,1076,23,1099,86
12/30/17,iq,1095,22,1117,83
12/31/17,iq,1059,28,1087,88
1/1/18,iq,1173,27,1200,83
1/2/18,iq,1108,21,1129,82
1/3/18,iq,1076,25,1101,82
1/4/18,iq,1083,26,1109,82
1/5/18,iq,1064,24,1088,86
1/6/18,iq,1144,26,1170,83
1/7/18,iq,1062,30,1092,83
1/8/18,iq,1050,33,1083,83
1/9/18,iq,1066,18,1084,85
1/10/18,iq,1054,,1054,82
1/11/18,iq,1074,,1074,81
1/12/18,iq,1094,,1094,84
1/13/18,iq,1098,,1098,83
1/14/18,iq,1101,,1101,82
1/15/18,iq,1124,,1124,81
1/16/18,iq,1090,,1090,80
1/17/18,iq,1089,,1089,82
1/18/18,iq,1103,,1103,83
1/19/18,iq,1185,,1185,78
1/20/18,iq,1165,,1165,78
1/21/18,iq,1048,,1048,83
1/22/18,iq,1021,,1021,83
1/23/18,iq,1082,,1082,82
1/24/18,iq,1115,,1115,80
1/25/18,iq,1143,,1143,78
1/26/18,iq,1173,,1173,77
1/27/18,iq,1151,,1151,78
1/28/18,iq,1189,,1189,74
1/29/18,iq,1122,,1122,76
1/30/18,iq,1112,,1112,56